****************
*    *    *   E*
*    *    *  ***
*         *    *
*    *    *    *
*    *    *    *
*S   *         *
****************